1111111111111111111111111111111111
1E0000000000000C00000C000000000001
1010010100100000101001000000010101
10100100C0101010001001000000010101
1E00A0000000000100000C000000AA0001
1010010100100000101001000000010101
101001001010101000100100A000010101
1P0000000100000000000000000000A0C1
100000000100100A0000000000000000C1
1111111111111111111111111111111111