111111111111111111111111
100000000000000001000001
10000011100000000W000001
1000000C100E000010000001
100000001000W00010000001
1000000000111111000C0001
100000W00000000000000001
100000000000C11111C00001
101110000000000000000001
101P000000000000000W0001
111111111111111111111111