111111111111111111111111
100000000000000001000001
100000111000000000000001
1000000C100E000010000001
100000001000W00010000001
10000W0000111111000C0001
100000000000000000000001
100000000000C11111C00001
101110000000000000000001
101P0000000W00000W000001
111111111111111111111111